27 21
300 300
7 7 7 7 7 7 7 7 7 7 7 7 7 7 7 7 7 7 7 7 6 6 6 6 6 6 6
7 6 6 6 6 6 6 6 6 6 6 6 6 6 6 6 6 6 6 7 6 6 6 6 6 6 6
7 6 6 7 7 7 7 6 6 6 6 6 6 6 6 6 6 6 6 7 6 6 6 6 6 6 6
7 6 6 6 6 6 6 6 6 6 6 6 6 6 6 6 6 6 6 7 6 6 6 6 6 6 6
7 6 6 6 6 6 6 6 6 6 6 6 6 6 6 6 6 6 6 7 6 6 6 6 6 6 6
7 6 6 6 7 7 7 7 6 6 6 6 6 6 6 6 6 6 6 7 6 6 6 6 6 6 6
7 6 6 6 6 6 6 6 6 6 6 6 6 6 6 6 6 6 6 7 7 7 7 7 7 7 7
7 6 6 6 6 6 6 6 6 6 6 6 6 6 6 6 6 6 6 6 6 6 6 6 6 6 7
7 6 6 6 7 7 7 7 7 6 7 6 6 6 6 6 6 6 6 7 7 7 6 6 6 6 7
7 6 6 6 6 6 6 7 6 7 6 6 6 6 6 6 6 6 6 7 7 7 7 7 6 6 7
7 6 6 6 6 6 6 7 6 7 6 6 6 6 6 6 6 6 6 7 7 7 7 7 6 6 7
7 6 6 6 6 6 6 7 6 7 6 6 6 6 6 6 6 6 6 7 7 7 7 7 6 6 7
7 6 6 6 6 6 6 6 6 6 6 6 6 6 6 6 6 6 6 7 7 6 6 6 6 6 7
7 6 6 6 6 6 6 6 6 6 6 6 6 6 6 6 6 6 6 7 7 6 6 6 6 6 7
7 6 6 6 6 6 6 6 6 6 6 6 6 6 6 6 6 6 6 7 7 6 6 6 6 6 7
7 6 6 6 6 6 6 6 6 6 6 6 6 6 6 6 6 6 6 7 7 6 6 6 6 6 7
7 6 6 6 6 6 6 6 6 6 6 6 6 6 6 6 6 6 6 7 7 6 6 6 6 6 7
7 6 6 6 6 6 6 6 6 6 6 6 6 6 6 6 6 6 6 7 7 6 6 6 6 6 7
7 6 6 6 6 6 6 6 6 6 6 6 6 6 6 6 6 6 6 7 7 6 6 6 6 6 7
7 6 6 6 6 6 6 6 6 6 6 6 6 6 6 6 6 6 6 7 7 6 6 6 6 6 7
7 7 7 7 7 7 7 7 7 7 7 7 7 7 7 7 7 7 7 7 7 7 7 3 7 7 7
